10 10
1111111111
S000000000
1111110011
0000000011
0000000011
0000111111
1100000000
0000111111
1100111111
000000000E
