10 10
1111111111
SSS0000000
SSS0000000
SSS0000000
0000000000
1111100000
0000000000
EEE0000000
EEE0000000
EEE0000000
